V V V B V V P V V V
V P V P V V V Z P V
B V V P Z V P V P V
P P P V V V P V V V
V V V V V R V P Z V
V P P P Z V P B P V
V V V P V V V V P V
Z P V B V P P C V C
V P V V V V Z V P V
V V V V R V V V G V